1111111111
1010001001
1010101101
1000100001
1111111111